+--+--+--+
         |
+--+--+  +
|        |
+  +--+--+
|        *
+--+--+--+
