+--+--+--+--+
   |     |  |
+  +--+  +  +
|     |     |
+--+  +--+  +
|     |     |
+  +--+  +  +
|        |  *
+--+--+--+--+
