+--+--+--+--+--+
   |           |
+  +  +--+--+  +
|     |        |
+--+--+--+  +--+
|  |        |  |
+  +  +--+--+  +
|  |  |        |
+  +  +  +--+--+
|              *
+--+--+--+--+--+

